1010111111101111111
1010000000101000101
1110111110111011101
1000100010100000001
1010101110111111101
1010000010100000000
1111101011111111111
0000101000100010100
1111101010111010111
0010001010100000100
1011101011101110111
1010001010001000000
1111111110101110101
0010100010101000101
1010101111111111101
1010000010001010001
1111111010101010101
0010001000101000101
1111101111101111111